TTTTTTTTTT
TGGTTTGGTT
TTGTGTGTGT
TGGGTTGGGT
TTTGTTTGTT
TGTGTGTGTT
TGGGGGGGGT
TGTTTGTGTT
TGGGGGGGTT
TTTTTTTTTT